BBBBBBBBBBBBBBBBBBBB
BBBXXXXXXXXBBBBBBBBB
BBX  RRR  RXBBBBBBBB
BBX RRRR  RXBBBBBBBB
BBXRR  RRRRXBBBBBBBB
BBXRR  RR  XBBBBBBBB
BBBXXXXXXXXBBBBBBBBB
BBBX X  X XBBBBBBBBB
BBBX      XBBBBBBBBB
BBBBXXXXXXBBBBBBBBBB
BBBBBBBBBBBBBBBBBBBB